M    V   T     V  T    V   T   M
M                              M
M                              M
M                              M
M                              M
MNNNNOOOOOOOOOOOOOOOOOOOOOO  OOM
M                    V        VM
MNNNNNN                    NNNNM
MT                             M
M     DDDDDD                   M
M                        NNNNNNM
M             NNNNN          PPM
M    NNNNNN                  PPM
M                    NNNNNNNNNNM
M                              M
MNNNNNNNNNNNNNNNNNNNNNNNNNNNNNNM
