L        V T    T            V L
L               V              L
L                              L
L                              L
L                      VA  A   L
LSSSSSSSSSSSSSFFFFSFFFFSSSSSSSSL
L                             VL
LSSS                           L
L                LLL A         L
LSSSS   DDDDDDDDDDDDDDDDDDDD   L
L                            SSL
L                              L
L            A      LLLFFFFFSSSL
L    SSSSSSSSSSSSSSS         PPL
L                            PPL
LSSSSSSSSSSSSSSSSSSSSSSSSSSSSSSL
